HHHHHHHHHHHHHHHHHH
HFNNNNNNNSNNNNNNNH
HNRRRRRRRSNNNNNNNH
HNNNNNNNNSNNRRRRRH
HNNBNNNNNSNNRNNNNH
HSSSSSSSSSSSRSSSSH
HNNNNNNNNSNNRNNNNH
HRRRNNNNNSNNRNNNNH
HNNRNNNNNSNNSNNNNH
HHHHHHHHHHHHHHHHHH