HHHHHHHHHHHHHHHHHH
HNNNNNNNNSNNNNNNNH
HNRRRRRRRSNNNNNNNH
HNNNNNNNNSNNRRRRRH
HNNNNNNNNSNNRNNNNH
HSSSSSSSSSSSRSSSSH
HNNNNNNNNSNNRNNNNH
HRRRNNNNNSNNRNNNNH
HNNRNNNNNSNNSNNNNH
HHHHHHHHHHHHHHHHHH